9 9 9 9 10 10 10 10 9 9 9 9 9 10 10 10 10 10 10 10 10 10 10 10 10 
10 10 10 10 10 10 10 10 10 10 10 10 10 10 10 10 10 13 13 13 13 10 10 10 10 
45 45 14 15 16 45 45 45 45 45 10 10 10 10 10 10 10 10 10 13 13 13 13 13 45 
11 9 22 24 25 11 11 13 13 10 10 10 10 10 10 10 10 10 10 10 10 11 11 11 11 
9 11 22 24 25 13 13 13 10 10 10 10 13 13 17 18 19 10 21 10 10 10 11 11 11 
13 13 22 24 25 45 13 13 10 10 10 13 13 13 26 27 28 13 13 10 10 10 13 45 45 
9 45 22 24 1 15 16 13 10 10 13 13 13 13 26 27 28 45 45 45 10 10 10 13 13 
9 13 29 4 24 24 25 13 10 10 10 45 45 9 26 27 28 45 13 11 10 10 10 10 13 
9 9 45 29 4 24 25 10 10 21 10 10 10 10 26 27 28 10 9 9 9 10 10 10 10 
9 45 9 11 29 4 25 11 11 10 10 10 11 11 26 27 28 11 37 10 10 10 10 10 10 
11 11 9 13 9 22 25 11 11 35 36 10 10 10 26 27 28 9 40 9 13 9 9 10 10 
11 9 13 13 9 22 1 15 16 38 39 9 9 9 22 24 25 13 43 13 9 10 10 13 10 
9 9 9 13 13 22 24 24 25 41 42 13 13 13 22 24 1 15 16 10 10 13 13 9 10 
9 9 9 9 9 29 30 4 1 15 15 15 15 15 0 24 24 24 25 13 9 9 9 10 10 
9 9 9 9 9 13 13 29 4 24 24 24 24 24 24 24 24 24 25 10 10 9 10 13 10 
9 9 9 10 10 10 9 9 29 30 30 30 30 30 30 30 30 4 25 10 10 10 10 10 10 
9 9 9 10 9 10 10 10 10 10 10 10 10 10 10 10 9 22 25 5 10 10 10 10 10 
9 9 9 10 10 10 10 10 10 10 10 9 10 9 9 9 9 22 25 10 10 10 10 10 10 
10 10 10 10 10 10 10 10 9 9 9 9 10 13 13 13 13 22 25 10 10 10 10 10 10 
9 9 10 10 9 9 13 10 10 10 13 10 10 10 10 10 10 29 31 9 9 10 10 10 10 
13 13 10 10 13 13 9 13 9 10 10 10 10 10 10 10 10 9 9 9 9 9 9 10 10 
13 13 10 10 10 10 13 13 10 10 10 10 9 9 9 9 9 9 9 9 9 13 13 10 10 