9 09 09 09 10 10 10 10 09 09 09 09 09 10 10 10 10  10 10 10 10 10 10 10 10 
10 10 10 10 10 10 10 10 10 10 10 10 10 10 10 10 10 13 13 13 13 10 10 10 10 
45 45 14 15 16 45 45 45 45 45 10 10 10 10 10 10 10 10 10 13 13 13 13 13 45 
11 09 22 24 25 11 11 13 13 10 10 10 10 10 10 10 10 10 10 10 10 11 11 11 11 
9 11 22 24 25 13 13 13 10 10 10 10 13 13 17 18 19 10 21 10 10 10 11 11 11 
13 13 22 24 25 45 13 13 10 10 10 13 13 13 26 27 28 13 13 10 10 10 13 45 45 
9 45 22 24 01 15 16 13 10 10 13 13 13 13 26 27 28 45 45 45 10 10 10 13 13 
9 13 29 04 24 24 25 13 10 10 10 45 45 09 26 27 28 45 13 11 10 10 10 10 13 
9 09 45 29 04 24 25 10 10 21 10 10 10 10 26 27 28 10 09 09 09 10 10 10 10 
9 45 09 11 29 04 25 11 11 10 10 10 11 11 26 27 28 11 37 10 10 10 10 10 10 
11 11 09 13 09 22 25 11 11 35 36 10 10 10 26 27 28 09 40 09 13 09 09 10 10 
11 09 13 13 09 22 01 15 16 38 39 09 09 09 22 24 25 13 43 13 09 10 10 13 10 
9 09 09 13 13 22 24 24 25 41 42 13 13 13 22 24 01 15 16 10 10 13 13 09 10 
9 09 09 09 09 29 30 04 01 15 15 15 15 15 00 24 24 24 25 13 09 09 09 10 10 
9 09 09 09 09 13 13 29 04 24 24 24 24 24 24 24 24 24 25 10 10 09 10 13 10 
9 09 09 10 10 10 09 09 29 30 30 30 30 30 30 30 30 04 25 10 10 10 10 10 10 
9 09 09 10 09 10 10 10 10 10 10 10 10 10 10 10 09 22 25 05 10 10 10 10 10 
9 09 09 10 10 10 10 10 10 10 10 09 10 09 09 09 09 22 25 10 10 10 10 10 10 
10 10 10 10 10 10 10 10 09 09 09 09 10 13 13 13 13 22 25 10 10 10 10 10 10 
9 09 10 10 09 09 13 10 10 10 13 10 10 10 10 10 10 29 31 09 09 10 10 10 10 
13 13 10 10 13 13 09 13 09 10 10 10 10 10 10 10 10 09 09 09 09 09 09 10 10 
13 13 10 10 10 10 13 13 10 10 10 10 09 09 09 09 09 09 09 09 09 13 13 10 10 